#############
#P          #
#  B        #
#    B ## T #
#  T     B  #
#    T      #
#############