#######
#P    #
#  B  #
#    B#
#  T  #
#    T#
#######