#########
#P    B #
#  B    #
#    B  #
#  T    #
#    T  #
#########